++++++++++
++ +  ++++
++ + ++ F+
++ +    ++
++   ++ ++
+S + ++ ++
++ + ++ ++
++++++++++