+-+-+-+-+-+-+-+
S         |   |
+-+ +-+-+ + + +
|   |     | | |
+ +-+-+-+-+-+ +
|   |     |   |
+ + + +-+ + +-+
| | |   | |   |
+ + + +-+ + + +
| | |   |   | |
+-+ +-+ +-+-+ +
|   |   |     |
+ +-+ + + +-+-+
|     | |     F
+-+-+-+-+-+-+-+