+-+-+-+-+-+-+-+-+-+-+
S   |         |   | |
+-+ + +-+-+-+ + + + +
|   | |       | |   |
+ +-+ + +-+-+-+ +-+-+
| |   |       | |   |
+ + +-+-+-+-+ + + +-+
|   |         |     |
+-+-+-+-+ +-+-+-+-+ +
|       |       | | |
+ +-+-+ +-+-+-+ + + +
|     |         |   |
+-+-+ +-+-+-+-+-+ +-+
|     |     |       |
+ + +-+ +-+ + +-+-+ +
| | |     | | |   | |
+ +-+ + +-+ + + +-+ +
|   | | |   | |     |
+-+ + + + +-+ +-+ +-+
|     | |     |     F
+-+-+-+-+-+-+-+-+-+-+