+-+-+-+-+-+
S   |     |
+-+ + +-+ +
|   |   | |
+ +-+-+ + +
|     | | |
+-+-+ + + +
|   |   | |
+ + +-+-+ +
| |       F
+-+-+-+-+-+