+-+-+-+-+-+
S   |   | |
+ +-+ + + +
|     |   |
+-+-+-+-+ +
|     |   |
+ +-+-+ +-+
| |     | |
+ + + +-+ +
|   |     F
+-+-+-+-+-+