+-+-+-+-+-+
S         |
+ +-+ +-+-+
| |       |
+ +-+-+-+ +
| |     | |
+ + +-+-+ +
| |   |   |
+ +-+ + +-+
|   |     F
+-+-+-+-+-+