+-+-+-+-+-+
S   |     |
+ + + +-+ +
| |   |   |
+-+ + + +-+
|   | |   |
+ +-+-+-+-+
| |       |
+ + +-+-+ +
|   |     F
+-+-+-+-+-+