+-+-+-+-+-+-+-+-+
S       |       |
+ +-+-+ + +-+-+ +
|   |   |     | |
+-+ + +-+-+-+ + +
|   |         | |
+ +-+-+-+-+-+-+ +
| |     |   |   |
+ +-+-+ + +-+ + +
|       |     | |
+-+-+-+-+ +-+-+ +
|       |   |   |
+ +-+-+-+-+ + +-+
| |     |   |   |
+ +-+ + + +-+-+ +
|     |   |     F
+-+-+-+-+-+-+-+-+