+-+-+-+-+-+-+-+-+-+
S     |           |
+ +-+ +-+ +-+-+-+ +
| | |     |       |
+ + +-+-+-+ +-+-+ +
|   |     |   | | |
+-+-+-+ + +-+ + + +
|   |   |   |   | |
+ + + +-+-+ + +-+ +
| | | |   | |   | |
+ + + + + + +-+-+ +
| |     | |       |
+ +-+ +-+ + +-+-+-+
| |   |   |       |
+-+ +-+ +-+-+-+-+ +
|   | |   |     | |
+ +-+ +-+ + +-+-+ +
| |   | |         |
+ +-+ + + +-+-+ +-+
|     |   |       F
+-+-+-+-+-+-+-+-+-+